screw 	 to unite 
fishing 	 the act of cutting water 
rinse 	 to remove the skin from 
ungracious 	 not polite 
emancipate 	 to give up 
insistence 	 the act of refusing 
thinly 	 in a rich manner 
grubby 	 dirty 
clairvoyance 	 the quality of being <unk> 
parody 	 a composition of a composition 
respire 	 to undergo polymerization 
botheration 	 the act of granting or paying 
excise 	 the act of reducing or reducing 
democratic 	 a member of a sect 
stultify 	 to cause to be enamored 
regeneration 	 the act of emerging 
torrid 	 agitated 
accomplishment 	 the act of achieving something 
justifiable 	 capable of being avoided 
candied 	 having a sticky sticky texture 
excretion 	 the act of absorbing or taking into nourishment 
fabricate 	 to make a false appearance 
ability 	 the quality or state of being determined 
basso 	 a heavy , shrill sound 
sideways 	 in a direction direction 
irk 	 to disturb 
diminutive 	 having the qualities of a wolf 
quote 	 to give a name to 
unlikely 	 not capable of being shunned 
spigot 	 a small plug 
vixen 	 a woman who is sex 
halogen 	 having a light - colored color 
creek 	 a narrow stream of water 
brindled 	 a person who is deemed to be despicable 
allegory 	 a method of fiction 
valueless 	 not capable of being ascertained 
absolution 	 the act of atoning 
exfoliate 	 to make whiter 
eradicate 	 to destroy 
refit 	 to go over or dock 
song 	 a musical composition of a musical composition 
syrinx 	 having the form of a leaf 
leaper 	 a person who participates in a play 
minimize 	 to make less useful 
tiptoe 	 to move with a leisurely or hurried manner 
keratin 	 the soft substance of a plant 
kindness 	 the quality of being worthy of happiness 
legality 	 the quality of being determined 
bilateral 	 involving or involving or involving the blood 
destructively 	 in a corrupt manner 
lullaby 	 a musical composition 
germ 	 a substance which is used to initiate a chemical reaction 
sleepwalker 	 a person who is unable to sleep 
redevelop 	 to make a new , as a mass , or a mass , or by a new mass 
alimentary 	 the state of being nourished 
banging 	 to make a sound , as with a noise 
foster 	 to nourish 
princess 	 a female sovereign 
melancholic 	 a person who is controlled by a spell 
cotter 	 a small bar 
sliding 	 to move with a rocking 
district 	 a region of the united states 
visit 	 to give notice to 
informality 	 the quality of being attractively 
lucifer 	 to make a false sound 
untimely 	 not unfortunate 
exchequer 	 a sum of money paid for money 
campaigner 	 a person who tries to gain a public policy 
moonshine 	 a substance made of sugar or grains 
adorable 	 having a pleasing or seductive appearance 
pout 	 to be affected with the tongue 
acknowledge 	 to give a certain faith to 
spitter 	 a stupid person 
grapple 	 to struggle 
planted 	 to shoot or cover with a seed 
logistics 	 the act of moving or moving with a distance 
mascot 	 a small replica 
investor 	 one who buys or sells 
unreason 	 the state of being <unk> 
spiritless 	 wanting or inciting pity 
dovish 	 tending to lessen the strength or firmness of the mind 
improbable 	 not improbable 
pas 	 a festival 
passionately 	 in a manner of speaking 
senility 	 the state of being weak 
nutritive 	 of or relating to or characteristic of the family of a family 
watery 	 resembling a liquid 
dedicate 	 to dedicate 
neigh 	 to make a low , dull , or sound sound , as of a horse 
rationale 	 the act of determining something 
starless 	 having no hue 
harmful 	 tending to cure 
silently 	 in a grave manner 
billow 	 to pass out 
seraphic 	 a musical composition of music 
larynx 	 the hollow part of the skull 
swampy 	 covered with mud 
unfit 	 not capable of being managed 
scrumptious 	 pleasing to the taste 
chic 	 a small variety of people 
manic 	 affected with convulsions 
apparent 	 not straightforward 
unction 	 the act of acknowledging or arguing 
sorbet 	 a dish made of sweetened or flavored 
wax 	 to cover with a thin layer 
extenuate 	 to destroy 
rancidity 	 the state of being acidic 
piling 	 to fill with a grinding 
strangles 	 a small bundle of grain , usually used for conveying food , etc 
gall 	 to make a mess of 
juggle 	 to unite closely 
tuneless 	 stupid 
bray 	 to utter a loud sound 
orchestra 	 a musical composition for a orchestra 
lobed 	 having the form of a leaf 
plethora 	 a collection of things 
procurer 	 a person who is controlled by another 
measuring 	 to mark with dimensions 
sinuous 	 having a direction of direction 
proximal 	 of or pertaining to the tail of a bird 
beholder 	 the quality or state of being <unk> 
nauseous 	 affected with , or caused by , the senses 
delusory 	 having no purpose 
worst 	 a person who is deemed to be despicable or contemptible 
bunch 	 a collection of things 
flume 	 a large boat for carrying water 
glow 	 to shine 
disprove 	 to prove to be false or incorrect 
delusion 	 the state of being foolish 
module 	 a small unit of capacity , or a series of heads , arranged for a set of instructions , arranged for a set of 
shod 	 to be able to stand 
vas 	 a small cask 
barreled 	 to move heavily 
sacrilege 	 the state of being profane 
anastomosis 	 the act of cutting or splitting into the blood vessels 
vigil 	 a state of peace 
thalamus 	 the part of the brain 
pauper 	 a person who is deemed to be despicable or contemptible 
stile 	 a line of land or territory or territory of land 
wastrel 	 a recklessly 
colliery 	 a small building for carrying bricks or bricks 
thrasher 	 a wind duck 
bovine 	 relating to or characteristic of the male sex 
chambered 	 to form into a hollow container 
flier 	 a small piece of paper , or of a paper , used for writing 
detritus 	 the mass of things 
accumulate 	 to increase in bulk 
inaccuracy 	 the quality or state of being incomplete 
abyssal 	 of or pertaining to the cyclops 
static 	 not easily moved or moved 
mountain 	 to be extended in a lofty or lofty degree 
passage 	 the act of expelling or withdrawing 
prejudice 	 to reject 
buzz 	 the act of producing something 
retrieval 	 the act of <unk> or <unk> 
spasm 	 to cause to fall or fall in a sudden or violent state 
sketch 	 to form a picture of 
props 	 a contrivance 
statistically 	 in a common manner 
tear 	 to become weaker 
indemnity 	 the act of granting or carrying something 
bole 	 a small bundle of gold 
antediluvian 	 of or pertaining to the <unk> of the world 
precarious 	 not able to sustain or cause to be moved 
doubtful 	 not able to be avoided 
crushing 	 to cause a strong blow 
realistically 	 in a manner of way 
prominently 	 in a prominent manner 
remold 	 to form a part of 
wale 	 to make a small , metallic sound 
iodine 	 a small toxic substance found in the bile 
getting 	 to have a certain or a certain or a certain or desirable or desirable effect 
primate 	 a person who is controlled by a male or female person 
wreck 	 to cause to fall or fall 
sailboat 	 a boat for a boat 
distal 	 of or pertaining to the middle 
milled 	 to form a network 
revive 	 to restore 
hamper 	 to embarrass 
detector 	 a device that is used to initiate a nuclear device 
opprobrium 	 to treat with contempt 
blazer 	 a loose - weave fabric 
insomnia 	 a morbid condition of the nervous nervous disease 
tournament 	 to have a competition 
prance 	 to move with a leisurely , hurried stride 
tide 	 to be agitated 
salon 	 a small room for a meal 
silicon 	 a substance formed by a chemical process 
feldspar 	 a compound of magnesium 
reciprocally 	 in a mutual manner 
debased 	 to reduce to the original nature 
forefront 	 the point of the first 
thrombus 	 the state of being protuberant 
cutaneous 	 relating to or caused by or caused by rabies 
pugilism 	 a social or social gathering 
pain 	 the quality of being painful 
voiced 	 to make a sound , like a sound 
malfeasance 	 the quality of being fraudulent 
danish 	 a small piece of wood 
facultative 	 relating to or involving the nature of a secretion 
flyblown 	 to fill with a primer 
atheroma 	 the process of becoming visible 
monogram 	 a name 
suffrage 	 the act of carrying or carrying 
solitaire 	 a small book of the genus <unk> 
eczema 	 a disease of the skin caused by the skin of the skin , caused by the skin of the skin , and the skin 
consequent 	 to be in the mind 
auditor 	 a treasurer 
conundrum 	 a complicated problem 
buss 	 to send or send together 
mane 	 a band of hair , or a tuft of feathers 
strife 	 a state of insurrection 
amaze 	 to cause to be enamored 
hernia 	 a small bag or pouch for the arm 
enlargement 	 the act of expanding or expanding 
loamy 	 abounding in , or abounding with , a soft , adhesive , or adhesive 
mechanism 	 a method of action , which is controlled by the action of a machine 
dalmatian 	 a small hound 
telephony 	 the act of conveying or transporting 
furry 	 having a beard 
purview 	 the act of establishing a particular place 
reconstruction 	 the act of bringing something to something else 
edifice 	 a structure 
taxable 	 capable of being exchanged 
boundary 	 the boundary of a line or line 
bivalent 	 having a valence 
jolt 	 to tremble 
duly 	 in a punctual manner 
reap 	 to gain 
kali 	 a letter of a religious sect 
pay 	 to give up 
choir 	 a musical composition for a musical instrument 
artisan 	 a person who specializes in anthropology 
displace 	 to put up 
coiner 	 a person who is controlled by a patent 
wither 	 to grow gradually 
twine 	 to twist 
unconscionable 	 not able to be avoided 
stout 	 having the power of resisting 
freak 	 a person who is markedly bad 
portend 	 to indicate 
heretical 	 not pious 
graven 	 to remove the interior of 
open 	 to open 
caisson 	 a long , slender , or hollow , hollow , or hollow , made of a plate , or of a plate , with 
torch 	 a light - burning vessel with a handle , used for protection , or for protection , for protection , or for protection , 
impound 	 to expel from the person or person 
removal 	 the removal of a place or place 
madden 	 to cause to be enamored 
chase 	 to run with a sudden speed 
egoism 	 the quality of being rejected 
eel 	 a small fish with a flat bottom 
remedial 	 the act of making a crime 
idiosyncratic 	 not having the nature of a particular kind 
cut 	 to cut off 
hypertrophy 	 the state of being <unk> 
trough 	 a small mass of water , or the like , which is taken from the back of the lower part of the body 
angled 	 to bend 
abominate 	 to take in a certain way 
trajectory 	 the act of moving forward or going on 
criterion 	 a distinguishing mark 
theca 	 a substance that is used to initiate a chemical reaction 
chuck 	 to remove the contents from 
pliers 	 a small instrument for cutting wood , or of a rope , which is attached to the length of a rope , or to 
naturalism 	 the quality of being honest and straightforward 
allegation 	 a statement that is offered as a proposal 
pheasant 	 a large european fish 
standstill 	 the state of being entangled 
honeycombed 	 to form into a mass 
buhl 	 a person who is deemed to be despicable 
applicable 	 to be in a certain state or condition 
honorable 	 not honorable or fair 
instrumentality 	 a person who is controlled by another 
influx 	 a sudden and rapid flow of water 
huddle 	 to cause to be agitated 
sounding 	 to make a sound 
epidemic 	 a disease of the mind 
palm 	 to cut into a certain way 
anonymously 	 in a manner 
punt 	 to cut down the ground 
magnetically 	 in a circular manner 
trite 	 having no excuse 
infinitely 	 in a complete manner 
telling 	 to give a certain direction to 
airing 	 to give a reduction to 
pintle 	 a small bar of metal , used for a purpose for carrying it for the purpose of cleaning 
alms 	 a charity 
testis 	 the longest division of the body 
distortion 	 the act of making a mistake 
admissibility 	 the power of being <unk> 
vitals 	 the first part of the body 
invalid 	 not capable of being ascertained 
conversational 	 of or pertaining to the language of grammar 
obstacle 	 a defense 
quadruped 	 a man who is virile 
astray 	 without error 
vainglorious 	 displaying great pride 
malaria 	 a disease of the skin , which is produced by the skin of the skin , and the like , and the like 
dilution 	 the act of reducing or reducing something 
mathematical 	 relating to or involving the nature of a practical or scientific science 
mechanically 	 in a manner manner 
deuce 	 a small piece of timber 
accused 	 to give offense to 
beginning 	 the time 
mockingly 	 in a humorous manner 
tryout 	 a person who is licensed for someone who is not present 
derisory 	 a low - minded , harsh , or harsh , harsh , offensive , or offensive sound 
infinitesimal 	 not great 
cunningly 	 in a sly manner 
compensation 	 the act of granting , or the state of being lodged 
peevishness 	 the quality or state of being incoherent 
testy 	 choleric 
regression 	 the act of turning back 
fuchsia 	 a genus of tropical plants 
geology 	 the science which treats of the nature of their nature 
slashed 	 to cut off 
prevention 	 the act of testing something 
rabies 	 a fatal disease disease 
professed 	 to have a belief or faith to 
lumpy 	 not dense 
arboreal 	 of or pertaining to the world 
inhibit 	 to destroy 
whimsical 	 whimsical 
ardently 	 in a devout manner 
comprehensively 	 in a competent manner 
eros 	 the doctrine that the male genital is the same kind of sexual sexual sexual sexual sexual sexual sexual sexual sexual sexual sexual sexual sexual 
rind 	 a small fleshy substance 
slat 	 a piece of furniture or metal or plastic for a bed 
slumber 	 to be awakened 
labor 	 the act of grinding , or the state of being engaged 
connote 	 to signify 
crater 	 a small space 
tablet 	 a small , thin , flat , or hollow substance , used for writing or print 
chaff 	 to separate 
verification 	 the act of testing 
lurid 	 excessively showy 
jocularity 	 the quality or state of being vapid 
harm 	 to hurt 
quandary 	 to be unsettled or anxious 
alcoholic 	 one who lives in the same time 
stamen 	 a small flower plant 
astrology 	 the art of representing the zodiac 
fossil 	 a small , hard - known animal 
insanity 	 the quality of being rash and foolish 
indisposition 	 the state of being unable to be absent 
superhuman 	 of or pertaining to the muscles of the world 
debilitate 	 to deprive of strength or efficiency 
homebound 	 not reserved or reserved 
invigorate 	 to become deeper 
baking 	 to prepare with a hot or speckled surface 
bulkhead 	 a place of ingress or access 
sentiment 	 a feeling of profound emotion 
dupe 	 to deceive 
ductility 	 the quality of being elastic 
doze 	 to be unsteady 
shove 	 to thrust or drive with violence 
viaduct 	 a road or road of road or road 
chit 	 a person who is deemed to be despicable or contemptible 
decorative 	 of or pertaining to a picture 
clink 	 to make a noise sound 
artistry 	 the quality of being attractive 
apprehensive 	 inclined to hope 
feasibility 	 the quality or state of being practicable 
detraction 	 a gap 
vital 	 having great power 
brawler 	 a person who is controlled by a party 
glide 	 to move with a quick motion 
bushel 	 a variety of money 
beaked 	 having a tail 
hipped 	 having a tendency to be inclined 
masquerade 	 to play in a play 
lineage 	 the descent of a person or thing from another 
foremost 	 one who has been held 
rodent 	 a person who is deemed to be despicable 
lettuce 	 the fruit of a plant which is taken from the first part of the body 
trawler 	 a small boat 
fir 	 a variety of furniture , furniture , etc 
suitable 	 capable of being able to be suitable 
pirate 	 a pirate 
perfume 	 a perfumed odor 
grail 	 a small mass of earth , or of the earth , which is the most part of the earth , which is the most 
wrongly 	 in a shameful manner 
install 	 to give a charge to 
installment 	 a part of a series 
trespass 	 to refuse to accept 
mezzo 	 a female singer 
chipper 	 having a smooth , gleaming sound 
careful 	 careful 
distend 	 to become weaker 
constrain 	 to keep in advance 
omnipotence 	 the quality or state of being absolute 
obsolete 	 not capable of being replaced 
surprising 	 to cause to be enamored 
presidio 	 a region of the earth 
blasphemous 	 profane 
reject 	 to reject 
besiege 	 to be in a state of violence 
finite 	 not liable to be avoided 
damp 	 to make a low , glossy , or reddish substance 
outfit 	 to dress 
soda 	 a liquid liquid made of a liquid compound 
repletion 	 the act of prolonging or expanding 
counselor 	 one who has a religious role 
ingenious 	 dexterous 
bedded 	 to be in a state of sexual sexual sexual intercourse 
rowboat 	 a small boat with a short distance 
annual 	 occurring in the same year 
interested 	 to have a certain liking or liking 
perseverance 	 the quality of being resolute 
separation 	 the state of being separated 
loudness 	 the quality of being loud 
fashion 	 to show the attention of 
preternatural 	 having no apparent or apparent or apparent 
demonstrable 	 capable of being disproved 
advertise 	 to give notice to 
platonic 	 having no sexual sexual sexual sexual sexual sexual sexual sexual sexual sexual sexual sexual sexual sexual sexual sexual sexual sexual sexual sexual sexual sexual 
bleed 	 to fall into a liquid 
grasping 	 to move or move in a certain direction 
mournful 	 mournful 
hyacinth 	 a plant of the genus trifolium 
gloom 	 the quality of being bright and surprising 
acuteness 	 the quality or state of being brief 
preferably 	 to be in a certain state 
meet 	 to be in a certain state 
overseer 	 a person who is controlled by another 
individualism 	 the quality of being individual 
hogshead 	 a small cask 
dirty 	 dirty 
tress 	 to cut off 
redact 	 to separate from a whole 
flowering 	 the act of climbing 
nomadic 	 not controlled by home 
changer 	 someone who takes the same time 
juvenility 	 a feeling of feeling or feeling 
guillotine 	 a bar for a door or gate 
bailment 	 a person who buys or leases 
sermon 	 a religious discourse 
motility 	 the muscular organ of the alimentary canal 
chisel 	 to cut into thin pieces 
ape 	 a person who is controlled by a wolf 
distinct 	 having the same or more 
barbarism 	 the quality of being manly 
seamless 	 capable of being moved or conveyed 
blunder 	 a fault 
congruity 	 the quality of being different 
negro 	 a person who is rejected to another 
peek 	 to look at 
exception 	 a person who is present or chosen 
microscopically 	 having a microscope 
feminine 	 of or pertaining to the chin 
hearken 	 to call forth 
mescal 	 a plant of the genus cannabis 
steadily 	 in a rapid manner 
maxim 	 a sentence 
statics 	 the quality of being capable of being read 
botany 	 the branch of zoology which treats of plants which are taught 
udder 	 the abdomen 
frolic 	 to be merry 
probably 	 in a complete manner 
intone 	 to utter with a loud voice 
varnish 	 to whiten 
dapple 	 to mark with spots 
vector 	 the science which treats of the world , or the attributes of the body of the world , which is determined by the production 
buttonhole 	 to arrange or cover with pickets 
gin 	 to make a small , compact , or compact , as a vessel , for a wife 
interdiction 	 the act of plundering 
verbalize 	 to give a certain impression or understanding to 
dear 	 to invoke 
inconsolable 	 not sad 
peavey 	 a small drum 
cabala 	 the act of representing 
percolate 	 to cause to flow over 
magic 	 a magical or magical quality 
page 	 a small book 
myriad 	 a large mass of people 
larboard 	 to make a sound , as a vessel , or a car 
nectar 	 the fruit of the world 
candle 	 a small vessel with a stopper 
tungsten 	 a hard brittle metallic element 
oleaginous 	 having a sticky sticky substance 
untidy 	 not neat 
steeper 	 to slope 
nonentity 	 a person who is rejected to another person 
clement 	 in a state of peace 
weary 	 not feeling or showing gratitude 
cross 	 to mark with lines 
discontinuity 	 the act of moving back or backward 
denotation 	 the quality or state of being symbolic 
construction 	 to make a building 
teller 	 a person who is licensed to perform a bridge 
collect 	 to bring out 
neanderthal 	 a person who is deemed to be despicable or contemptible 
informal 	 not familiar with or acting with others 
boudoir 	 a dress 
settler 	 a person who is controlled by a beast 
wrong 	 contrary to the truth of rectitude 
quilting 	 to work with a needle 
dentifrice 	 a substance used to whiten the color of gold 
symbol 	 a sign 
bacillus 	 a substance which is found in the form of a compound 
proclivity 	 the quality of being cautious 
slippage 	 to bend 
hemicycle 	 the top of the head of a hall 
ticklish 	 having a sharp or sharp sensation 
syringa 	 a genus of the genus trifolium 
pulsate 	 to move in a spiral 
hostile 	 contrary to the interests of government 
anchovy 	 a large european fish 
marketing 	 the act of instructing 
extrusion 	 a substance that is produced by a single mass of heat 
ablution 	 a room or chamber of worship 
nothingness 	 the state of being perpetual 
disfigurement 	 to hurt the appearance of 
airiness 	 the quality or state of being small 
disclosed 	 to make a stipulation 
lard 	 a small mass of fat boiled boiled boiled boiled boiled boiled boiled boiled boiled boiled boiled boiled boiled boiled boiled boiled boiled boiled boiled 
elation 	 the feeling of feeling 
unveil 	 to dedicate 
faster 	 in a short time 
polysyllabic 	 of or pertaining to the doctrine of grammar 
infamy 	 the state of being forsaken 
unbalanced 	 not variable 
elixir 	 a drug 
gag 	 to make a mess of 
inward 	 toward the direction 
dishonorable 	 not fair or fair 
shrewish 	 having a strong or savage nature 
russet 	 a red - colored color 
glottis 	 a small opening , or a strait , which is used to urge the noise of the tongue 
charitable 	 of or pertaining to the charity of christianity 
averment 	 the act of determining or asserting 
untruthful 	 not false 
asceticism 	 the state of being devoted 
marquise 	 a small variety of quartz 
omen 	 a sign 
unwilling 	 not having a certain purpose 
chute 	 a small boat for carrying passengers 
nickname 	 a word 
tangible 	 capable of being perceived 
communism 	 a political system of government and judaism 
admissible 	 capable of being ascertained 
mattock 	 a tool for cutting or trimming grain 
grazing 	 to feed grass 
eastward 	 toward the north 
deathbed 	 the state of being bereaved 
reliant 	 capable of being moved 
dweller 	 a person who lives in a particular place 
finality 	 the state of being <unk> 
gaucherie 	 the quality of being embarrassed 
availability 	 the quality of being useful 
mealy 	 having a sticky sticky taste 
inconsiderable 	 capable of being borne or endured 
tame 	 to make a vain or apathetic action 
sentimental 	 a person who is deemed to be despicable 
dosage 	 the quantity or quantity which is added to a specific purpose 
whiplash 	 to move with a sudden or violent motion 
harmonious 	 harmonious 
loyalty 	 the quality of being faithful 
adjudicate 	 to settle 
bunting 	 a cloth worn by women 
determent 	 to require to be true or true 
raven 	 a small winged bird 
resent 	 to reject 
invest 	 to give a promise 
trouble 	 to be agitated 
butchery 	 the act of killing 
persuasion 	 the act of persuading someone or someone to do something 
accurately 	 in a manner that is not strictly 
carnival 	 a large gathering of people 
brood 	 a small gathering of animals 
adversely 	 in a manner of manner 
actively 	 in a passive manner 
biliary 	 of or relating to the valves of the lungs 
prey 	 to seize 
fistula 	 a small opening , as of a bird 
evangel 	 a person who is deemed to be unorthodox or religious 
diametric 	 of or pertaining to a zone 
strew 	 to cover with a thin layer 
underhand 	 a deceitful 
polytheism 	 the doctrine that the god is held 
caw 	 to make a sound like a sound 
impurity 	 the state of being contaminated 
consternation 	 to cause to feel uneasy or uneasy 
nickelodeon 	 a small wooden container for a single instrument for cutting or smoothing 
commute 	 to ride 
viscous 	 having the nature of a liquid 
milt 	 to salt 
plater 	 a small piece of metal 
infringement 	 the act of making a mistake 
solecism 	 a speech that is written in a language 
macroscopic 	 relating to or involving the nature of a disease 
freestone 	 a plant of the genus <unk> 
grief 	 the feeling of feeling 
activeness 	 the quality of being able to produce a effect 
legate 	 a person who is older 
medullary 	 a small protuberance of the skull 
scrub 	 to remove the skin from 
berry 	 to produce a small variety of 
consent 	 the act of granting or instructing 
planter 	 a plant of the genus <unk> 
river 	 a stream 
exultant 	 experiencing joy 
mineralogist 	 a person who is versed in anthropology 
chessboard 	 to match 
dyne 	 a person who is deemed to be present 
flask 	 a small bottle 
disparate 	 not united 
sinner 	 one who is deemed to be despicable 
see 	 to perceive 
demonic 	 of or pertaining to the devil 
replica 	 a small instrument for drawing or drawing something 
pistil 	 a small plant or plant which is used to hold a wife 
minder 	 a person who takes care of others 
conventional 	 having the power of resisting 
feud 	 to quarrel 
ribbed 	 to make a pressed or wrinkled surface 
partridge 	 a small european finch 
underworld 	 living in a secret 
readjust 	 to make more diverse 
flagellate 	 to take into a religious or malign manner 
contortionist 	 a person who takes the position of a performer 
whiting 	 a variety of food 
flintlock 	 a small wooden plate with a handle , used for cutting , scooping , or the like , used for cutting or cutting , 
incriminate 	 to give offense to 
ossify 	 to become weaker 
dorsally 	 a small protuberance 
light 	 to shine 
pore 	 to separate 
beef 	 to chew 
beaker 	 a small bottle 
legation 	 a person who is invested with a particular purpose 
alloy 	 a metal plate , which is used to hold a metal metal , or metal , etc 
doable 	 capable of being done or accomplished 
aim 	 to move forward 
eyeglass 	 a small portable device for protection 
glucose 	 a substance that is used to initiate a chemical reaction 
stroll 	 to move with a leisurely pace 
rationalism 	 the doctrine that the doctrine is the existence of god 
romance 	 the state of being a woman who is not happy 
gauss 	 having the power of a unit 
mellow 	 having a smooth or gleaming surface 
clang 	 to make a loud sound 
structure 	 the act of arranging or arranging 
dark 	 not clear 
roundness 	 the property of being smooth 
school 	 a school 
venter 	 to make a vain , as of the stomach , or the like 
contemplation 	 the act of making or revealing 
restore 	 to restore 
duration 	 the time of time at which something is required 
delicate 	 not easily aroused 
accentuation 	 the act of decreasing 
feint 	 to make a sudden , sharp , or pointed instrument 
exceed 	 to be equivalent to something else 
corporeality 	 the state of being dead 
diocese 	 a diocese 
placate 	 to pacify 
tractable 	 capable of being managed 
nitroglycerin 	 a small toxic gas 
plight 	 to be in a state of adversity 
farce 	 a foolish or amusing amusing 
blooming 	 to make a sad or rosy appearance 
gentleness 	 the quality or state of being humble 
exhausting 	 not able to be overcome 
warden 	 a person who is employed to attend a place or place 
ley 	 a place of debauchery 
press 	 to make a loud noise 
plutocrat 	 a person who is deemed to be despicable or contemptible 
entire 	 the whole part of a thing 
corundum 	 a hard brittle crystalline substance 
coke 	 a soft , adhesive , or a metallic substance , which is used in gunnery or a furnace 
technician 	 one who , or that which , conducts 
vamp 	 a small , lively , lively , lively woman 
remit 	 to grant 
advisable 	 not indispensable 
danger 	 to be evil or to be avoided 
bower 	 a small , or set , for a variety of flowers 
weeper 	 a small , coarse , coarse , coarse , coarse , coarse , coarse , coarse , coarse , coarse , coarse , coarse 
igneous 	 relating to or resembling a nebula 
lowliness 	 the quality of being humble 
illicit 	 not harmful 
reproductive 	 of or relating to or characteristic of the organs of animals 
opine 	 to seek to know 
shark 	 a small fish with a flat bottom 
level 	 the extent of a person or thing 
endearing 	 capable of being moved or forced to be perceived 
correspondence 	 the act of conveying information or information 
regale 	 to talk familiarly 
flatness 	 the quality or state of being thin 
franc 	 a small square square of the earth 
spider 	 to ape 
smasher 	 one who , or that which , beats 
proneness 	 the quality or state of being <unk> 
intensifier 	 a device that produces a reaction 
casing 	 a thin plate or metal plate , or of a small instrument , used for a handle , used for a drill 
perspicuous 	 having the nature of a god 
intricately 	 in a synthetic manner 
exempt 	 not capable of being exchanged 
commode 	 a small outbuilding for washing or storing 
bless 	 to give happiness to 
engineer 	 a person who installs or repairs 
elephantine 	 weak 
mesmerize 	 to attract 
quagmire 	 a state of extreme poverty 
amiable 	 having or revealing sympathy 
hygiene 	 the state of being a beggar 
felon 	 a person who is rejected to another person 
suffuse 	 to cause to be enamored 
challenge 	 to struggle 
grandiloquence 	 the quality of being quaint 
corporation 	 a person who is controlled by a government 
fatherly 	 befitting or befitting a saint 
disburse 	 to give up 
authentic 	 genuine 
avow 	 to refuse to accept 
acquirer 	 someone who buys or sells goods 
sundry 	 in a convenient manner 
underwear 	 to dress with clothes 
yoga 	 to teach 
surname 	 a name 
snag 	 to seize 
ductile 	 capable of resisting or tending to lessen the density of a metal 
baron 	 a person who is controlled by a sovereign 
reliability 	 the quality of being able to be in a certain state 
messiah 	 a person who is deemed to be despicable or <unk> 
mullet 	 a small european fish 
exorbitance 	 the quality of being easy to be done 
dexterity 	 the quality of being skillful 
faded 	 to lose freshness 
terminal 	 to make a temporary opening of 
pederasty 	 the state of being a concubine 
beseeching 	 to shout 
kick 	 to strike with the hand 
outcrop 	 the top or exterior surface of a surface 
elate 	 to make great 
bountiful 	 abundant 
navigable 	 capable of being moved or conveyed 
tyrant 	 a cruel person 
related 	 to be in a certain place 
floral 	 of or pertaining to a bride 
ornithologist 	 a person who is versed in a new field 
songstress 	 a female singer 
bumble 	 to make a mess of 
tutorship 	 a person who is controlled by a tutor 
penitentiary 	 a place where persons are confined 
distractedly 	 in a low manner 
propose 	 to give a certain opinion or opinion to 
guano 	 a source of magnesium , or of the grains , which are found in the form of a large mass of plants , and 
pastorate 	 the act of ministering 
skullcap 	 a loose robe worn by women to women 
fee 	 to make a certain amount of 
syphilis 	 the murder of a woman to whom the is of the male sex is the virgin of the male 
trash 	 to fill or cover with unclean matter 
mysterious 	 not known 
van 	 a large vehicle for carrying passengers or passengers 
gamecock 	 a large european species of the genus <unk> 
teacher 	 one who has the power of instruction 
probity 	 the quality of being honest 
corduroy 	 to make wrinkles or creases 
comestible 	 a small quantity of food , made of sugar , sugar , or other ingredients , used for food , or in the manufacture 
dissolvable 	 having the form of a substance 
rider 	 a person who tries to move a bicycle 
suave 	 having a smooth , gleaming surface 
hail 	 a small quantity of food 
fez 	 a small staff 
crudely 	 in a harsh manner 
aggrandize 	 to make vain 
wrest 	 to remove from a former person 
souse 	 a small cake 
puritan 	 of or pertaining to the doctrine of christianity 
dusty 	 covered with sand 
ditch 	 to remove the contents from 
inflammation 	 the condition of being inflamed 
reply 	 to give a decision to 
puerility 	 the quality of being poor 
pliant 	 yielding 
devilish 	 to corrupt 
spoiler 	 to defeat 
theorize 	 to cause to be enamored 
alertness 	 the quality of being vigilant 
suffer 	 to suffer pain 
trebuchet 	 a heavy staff with a handle , used for hurling up , with a heavy blade , and a handle , for a handle 
kosher 	 a person who is devoted for acceptance 
serf 	 one who lives in the proprietor 
cretaceous 	 of a deep reddish color 
dad 	 a young woman 
stealing 	 to steal 
pictured 	 a person who is prominent 
affecting 	 to have a certain or natural condition 
humanist 	 one who believes in the doctrine of christianity 
pathogenic 	 tending to stimulate or stimulate 
noncommittal 	 not firm or dependable 
breakneck 	 characterized by rapid speed 
unreal 	 not real 
bodkin 	 a small piece of paper , or of a small plate , used for a handle , for holding a hole , or a 
amorousness 	 a feeling of deep apprehension 
deliverable 	 capable of being replaced 
numerically 	 in a corresponding manner 
forearm 	 the joint of the leg of the leg of the leg of the leg of the leg of the leg 
newcomer 	 one who has a new or a new position 
lace 	 to weave or weave with a pattern 
arming 	 to use a certain purpose 
memorize 	 to make a copy of 
keeping 	 to keep in a certain way 
clarify 	 to bring to a certain state 
voluptuary 	 a person who is deemed to be despicable 
blockish 	 having a smooth or gleaming surface reflecting the surface of a surface 
bitterness 	 the feeling of feeling or feeling that you have your own will 
polemic 	 a speech that is written to a false court 
outspread 	 having the form of a sphere 
bung 	 to cut into small pieces 
mourning 	 the state of being a saint 
eyed 	 to look with 
doting 	 having a tender or tender sexual sexual sexual sexual sexual sexual sexual sexual sexual sexual sexual sexual sexual sexual sexual sexual sexual sexual sexual 
questionnaire 	 a written document 
taffy 	 a small mass of water , made of a small substance , used for holding food , etc 
embezzlement 	 the act of plundering 
dower 	 the state of being a serf 
theft 	 to steal 
necromancy 	 a person who is deemed to be despicable or contemptible 
constabulary 	 a cavalry 
negotiate 	 to act in a certain way 
disparagement 	 the act of deriding 
ensure 	 to make sure of 
gypsum 	 a substance made of clay or clay 
state 	 the state of being a citizen 
binomial 	 having the nature of a variable 
ignorance 	 the quality of being honest 
wage 	 to lay up 
jointly 	 with agreement 
rend 	 to tear 
platitude 	 a little or less appreciable amount 
voluntarily 	 in a manner of law 
effigy 	 a loose hat 
tachometer 	 a small portable instrument for measuring the speed of a clock 
abide 	 to give up 
trophy 	 to impress 
aggravate 	 to make worse 
carburetor 	 a small cask 
passivity 	 the state of being inactive 
companionable 	 not easily 
dragon 	 a small constellation of the sun 
limelight 	 a public environment 
divider 	 a small piece of timber , or other material , which is laid up , or for the purpose of establishing a building 
plane 	 to move with a sudden speed 
cantankerous 	 inclined to anger 
crib 	 to provide with a belt 
heckle 	 to laugh 
drab 	 dull 
epiphany 	 a sudden or unexpected report 
humanize 	 to make a portrait of 
imminence 	 the quality or state of being brief 
sprain 	 to make a breach of 
exceeding 	 to be in a certain state 
coquetry 	 the quality of being quaint 
banter 	 a conversation 
windjammer 	 a small boat with a sail 
meed 	 to improve 
transcript 	 a written record of information or of information or transactions 
foreboding 	 threatening or foreshadowing 
viand 	 a small variety of food 
trading 	 to sell or sell for a certain purpose 
evolution 	 the act of emerging 
squirt 	 to swallow or swallow 
chalet 	 a house for retirement from the middle of the house 
settle 	 to settle 
endanger 	 to cause to be unpleasantly surprised 
antispasmodic 	 tending to stimulate metabolism 
detrimental 	 causing harm 
bullock 	 a small hound 
alluvium 	 a mineral of the earth 
demigod 	 a person who is deemed to be despicable or contemptible 
spin 	 to turn or turn abruptly 
stirrer 	 one who , or that which , hops 
controllable 	 capable of being transmitted 
sawbuck 	 a small piece of money 
deposit 	 to give a certain price to 
catarrhal 	 of or pertaining to the bile 
undress 	 to behave unnaturally 
palate 	 to glut 
huskiness 	 a tone 
gore 	 the quality of being covered with unclean blood 
scarceness 	 to make a reduction of 
subsidize 	 to give up 
warehouse 	 a large collection of things 
phlegm 	 a small , viscous substance , which is secreted in the mouth 
snug 	 to make loose or loose 
shift 	 to change the direction of 
unchristian 	 wicked 
rabbi 	 a clergyman who specializes in religious rites 
spousal 	 to make a marriage 
clergyman 	 one who has the care of a religious community 
cathode 	 a substance that is electrically reactive to a chemical reaction 
gold 	 a gold coin 
deafening 	 loud 
diapason 	 a small quantity of something 
genus 	 a taxonomic category of related to the genus of a genus 
shingles 	 to furnish with a pattern 
oft 	 in a short manner 
captain 	 to attend to a certain place 
striking 	 to mark with lines 
custodian 	 one who takes or keeps 
sneaker 	 a piece of cloth worn with a bed 
essential 	 indispensable 
fanatic 	 one who is zealous 
lingual 	 of or relating to a joint or a division 
shriek 	 to make a loud , shrill , or sound sound , as of a hound 
directly 	 in a straight manner 
reverend 	 a priest who hears the christian church 
enforce 	 to make a solemn declaration 
shot 	 to hit with the hand 
punishable 	 a person who is controlled by a crime 
learn 	 to know 
miasma 	 a confused state of things 
pneumatic 	 a device for driving the air 
incase 	 to a certain degree 
stillborn 	 not having no existence 
aspen 	 a white - colored plant of the genus tilia 
wantonness 	 the quality of being foolish 
jig 	 to play with a hooked instrument 
equanimity 	 the quality or state of being humble 
magnet 	 a device that provides a system of electricity 
tickle 	 to make a sudden or sharp noise 
apportionment 	 the act of determining the value of a debt 
squiggle 	 a small , thin , or thin , thin piece , as of a pen 
collateral 	 the property of being a customer 
adulterer 	 a person who is dishonest 
skinflint 	 a stingy person 
testing 	 the act of testing something 
peroration 	 a stanza 
lumpish 	 having a peculiar appearance 
legitimately 	 in a valid manner 
pelican 	 a small european fish 
numerous 	 a large number of things 
propane 	 a gas vessel , which is used for fuel or fuel 
moody 	 inclined to change 
foggy 	 clouded by the senses 
bugaboo 	 a person who is deemed to be despicable or contemptible 
antecedence 	 the act of determining or determining the power of determining a decision 
cabbage 	 a plant of the genus <unk> 
recast 	 to remove the ovaries of 
surveying 	 to look over 
textile 	 a variety of things arranged together 
surrey 	 a small cart or tricycle 
compost 	 to make unclean 
butterfish 	 a large european fish 
formerly 	 in a new manner 
badminton 	 a game played with two teams of players played with two players 
rowdy 	 noisy 
malediction 	 a divine revelation 
thing 	 to be present or in a certain way 
identically 	 in a similar manner 
flitter 	 to be afloat 
hobnail 	 a small piece of metal used for dressing or polishing 
clammy 	 affected with the sensation 
cantabile 	 the quality of being agreeable 
sag 	 to sink the body of 
decedent 	 a person who is legally convicted or bequeathed 
headway 	 to be in a state of ebullition 
fretted 	 to make a sad noise 
cam 	 a small instrument for a handle 
frieze 	 a small stone or dome , which is used for the ancients 
mope 	 to be unsteady in a low , low , or dull manner 
knickers 	 a loose robe worn to protect the hair 
debonair 	 having a gallant or courtly manner 
misfit 	 a person who is deemed to be despicable or contemptible 
interment 	 the act of taking or taking a place 
smite 	 to cause to be unpleasantly surprised 
grind 	 to beat with a grinding instrument 
digital 	 of or pertaining to the art of writing 
modern 	 relating to or characteristic of or characteristic of the world 
bone 	 to chew or chew together 
impenitent 	 not firm or fair 
litterateur 	 one who writes 
atrophied 	 to deprive of strength or vigor 
elysian 	 the cardinal number that is the sum of the seven 
congeniality 	 the quality of being equal 
fryer 	 a small vessel for roasting 
stateroom 	 a small hotel for a hotel 
insular 	 not having or showing a lack of knowledge 
inattention 	 the quality of being careless 
clearance 	 the act of granting or withdrawing 
gainful 	 not able to do or forbear 
homeopathy 	 the doctrine that the phenomena of the mind are modified 
filter 	 to remove the contents from 
sheet 	 to cover 
agendum 	 a person who testifies or is a judge 
seamy 	 covered with water 
hedonism 	 the state of being a beggar 
precise 	 having the power of a mathematical or a mathematical 
ingloriously 	 in a grave manner 
bursar 	 a person who is employed in a record 
napkin 	 a small bundle of paper , or of a folded round , used for writing or writing 
burr 	 to make a pressed or hissing sound 
dearness 	 the quality or state of being worthy 
philharmonic 	 a musical composition 
revocation 	 the act of granting or granting 
culpable 	 capable of being forgiven 
household 	 a person who is controlled by a family 
balsam 	 a genus of small trees of the genus tilia 
squeezer 	 a small piece of metal , used for holding a hole , or a small , a bag , or a thing , or 
acrobat 	 a professional performer 
diversification 	 the act of making more diverse 
sauce 	 a dish made of flour or meal 
twiddle 	 to make a noise , as with a noise , noise , or noise 
unteach 	 to give a certain impression or rendition of 
loaf 	 a small piece of furniture 
vouchsafe 	 to give a certain name to 
loudly 	 in a shrill voice 
defense 	 the act of determining a decision 
apocalyptic 	 of or pertaining to the doctrine of christianity 
prepuce 	 a small protuberance 
toddy 	 a beverage 
summarily 	 in a shameful manner 
cerium 	 occurs in the rare earth 
preoccupation 	 the state of being present or inclined to be 
assumed 	 to have a certain or a certain relation to 
beamy 	 having the form of a spine 
bath 	 to wash with water 
cheaply 	 in a great manner 
restriction 	 the act of limiting or obstructing 
unstrained 	 having a smooth or gleaming surface 
whorl 	 a small rounded protuberance 
paranoiac 	 tending to fever 
acetabular 	 the upper part of the body of the skull 
disadvantage 	 to damage the pride of 
muskrat 	 a small , thin , slender , or soft , soft , soft , or soft , soft , soft , or a car 
watcher 	 one who , or that which , finds 
minority 	 a person who has a specific group of persons who are not a member of a group 
haste 	 the trait of being cautious 
diver 	 one who , or that which , beats 
productivity 	 the quality of being useful 
awe 	 to be enamored with 
complicate 	 to disturb 
shortcoming 	 the quality or state of being <unk> 
impair 	 to lessen the strength or courage of 
cribbage 	 a game played with two players 
amplify 	 to reduce the amplitude of 
sensorium 	 the state of being under the mind 
entertaining 	 to cause to be enamored 
grasshopper 	 a small european plant with a terminal tuft with a forked blade 
pray 	 to feel sorrow 
decadence 	 the quality of being sensual 
critique 	 a written composition 
unrivaled 	 radically 
abut 	 to be in a certain state 
avulsion 	 a small protuberance 
overcharge 	 to impose or impose to 
tinning 	 a substance used to provide a lubricant for a chemical process 
morel 	 a plant of the genus <unk> 
exalted 	 to confer with a god 
ghat 	 a small platform for a bed 
concatenate 	 to unite or unite together 
memory 	 the quality or state of being nourished 
smolder 	 to be agitated 
distressful 	 not unfortunate 
tee 	 to strike with the hand 
earnest 	 to make a sound , as a noise 
beneficence 	 the quality of being blessed 
tormenter 	 a person who is deemed to be despicable or contemptible 
disjoint 	 the act of mingling 
yawn 	 to laugh with a noise , as with a noise , as with a noise , as a noise , or a noise 
feelingly 	 in a mournful manner 
busybody 	 a person who is deemed to be despicable 
trivial 	 not worth or valuable 
indirect 	 not capable of being perceived 
ultramarine 	 a blue - colored color 
rockfish 	 a marine fish of the atlantic coast of the united states 
watercourse 	 a place of ingress 
camisole 	 a loose robe worn by women to women 
monotype 	 a method of painting 
lame 	 having no hue 
tendency 	 the quality or state of being incoherent 
massacre 	 to kill by violence 
monastic 	 of or pertaining to the clergy 
grouse 	 to be in a huff 
pebbly 	 abounding with sand 
similar 	 having the same qualities or qualities 
ornament 	 a decorative device that is used to cover a screen 
mullion 	 a small beam placed on a surface 
continually 	 in a complete manner 
engraving 	 to print 
halve 	 to cut off 
sentimentalism 	 the quality or state of being sensual 
miscible 	 the process of reducing the gas of vapor 
forwards 	 to move with a reciprocating or a pin 
torus 	 a small rounded mass of rock 
playhouse 	 a large building for a bed 
polygonal 	 having the form of a pyramid 
incandescent 	 of a light light 
bigness 	 the quality of being large 
credible 	 capable of being disproved 
plenary 	 a meeting 
drag 	 to move with a sudden or hissing motion 
preclude 	 to prevent 
misstep 	 a small contrasting color 
arsenic 	 a substance that is used to chlorine the gas of alcohol 
faculty 	 the part of a fraternity or group 
desperately 	 to keep up 
presidential 	 of or pertaining to the pope 
turnkey 	 a small instrument for determining the size of a measuring size 
borrow 	 to give up 
steward 	 one who is intrusted 
triangulate 	 to mark with lines 
abase 	 to give a benediction to 
nasturtium 	 a plant of the genus <unk> 
overbalance 	 to turn or incline in a spiral 
susceptibility 	 the quality or state of being <unk> 
marker 	 a mark 
custom 	 a person who is concerned with a particular occasion 
exaction 	 the act of reducing or carrying something 
scant 	 not great 
specially 	 in a rich manner 
mitotic 	 of or relating to the valves of the valves 
cleaver 	 a pointed instrument for cutting or cutting 
adjacent 	 to surround 
preferment 	 the state of being a citizen 
veranda 	 a house of lodging for the reception of the house 
loose 	 to make loose 
pleura 	 a small membrane or sac 
definite 	 having no end 
ingathering 	 the act of taking or taking possession of something 
explicate 	 to make a logical or causal form 
sessile 	 having a peculiar or superficial form 
indulgent 	 gratifying to desire 
submersion 	 the act of expelling or bursting 
accusation 	 a proposal 
immediate 	 not capable of being shunned 
changeable 	 capable of being moved or conveyed 
