affecting 	 to make a certain or causal difference 
incriminate 	 to refuse to acknowledge 
beamy 	 to make a resonant sound of 
baron 	 a person who has been admitted to be employed 
numerically 	 in a nominal manner 
incandescent 	 of or pertaining to the spectrum 
extrusion 	 the process of making a series of water or metal 
dirty 	 to dirty 
omen 	 a sign or event 
rend 	 to make a low , broken , or twisted 
dusty 	 to make a pressed or wrinkled 
mathematical 	 of or relating to the science of logic 
digital 	 of or pertaining to the nature of a particular subject 
bumble 	 to make a mess of 
plater 	 a long - pointed missile that is used to trim a plate 
identically 	 in a manner or manner 
proclivity 	 a disposition to be preferred 
install 	 to cause to be attached 
gaucherie 	 the quality of being asinine 
cross 	 to be in a certain manner 
technician 	 a person who installs a business 
alms 	 a gift 
eastward 	 toward the point 
varnish 	 to cover with a surface 
obstacle 	 a defense 
mechanism 	 a structure 
cathode 	 a negatively charged with a vitreous 
diocese 	 a body of christian church , or the jurisdiction of a bishop 
aggrandize 	 to make a high - minded or more disguised purpose 
milt 	 a plant of the genus family 
lineage 	 the kinship of a person or group 
glide 	 to move along the surface of , as a horse 
limelight 	 a public entertainment 
botheration 	 the act of making or maintaining something 
entire 	 the interval of a circle 
challenge 	 to oppose 
mineralogist 	 a member of the united states 
airiness 	 the quality of being quaint 
lumpish 	 a person who is not easily aroused 
genus 	 a collection of leaves and leaves and leaves and leaves and leaves and leaves and leaves and leaves and leaves and leaves and leaves 
watery 	 of or pertaining to the color 
measuring 	 to make a mathematical calculation or computation 
bless 	 to give a benediction to 
grouse 	 to feed with hounds 
dweller 	 someone who lives on the place of residence 
frolic 	 to wander 
balsam 	 a tree or shrub of the genus family 
anastomosis 	 the act of expelling the fibers of a wound 
reap 	 to gain advantage 
madden 	 to cause to be unable to think 
lullaby 	 to sing with a melodious voice 
diver 	 a person who crawls on the water 
lingual 	 a mark of a word 
antispasmodic 	 of or relating to the throat 
drag 	 to walk in a stealthy or difficult manner 
subsidize 	 to give a charge to 
graven 	 to mark with a sheath 
demonic 	 of or pertaining to the nature of a god 
ignorance 	 the quality of being honest 
whiting 	 a small european finch 
accurately 	 in a manner to make a mathematical or correct form 
textile 	 a work of work or occupation 
unrivaled 	 not liable to be eminent 
numerous 	 a large number of things 
chisel 	 to cut or cut off 
accused 	 to make a respectful or respectful manner 
stultify 	 to make a mystery or bewildering to 
apparent 	 evident 
decedent 	 a person who is owned by a person or thing is insured 
botany 	 the branch of zoology 
infinitely 	 in a manner or to a greater purpose 
hernia 	 the fourth of the leg 
moonshine 	 a fermented plant 
basso 	 a musician 
nothingness 	 a state of being forsaken 
installment 	 a short or series of things 
beef 	 to prepare 
syphilis 	 a disease of the skin of a plant 
absolution 	 the act of liberating 
fistula 	 the act of expelling the bowels of a body 
legation 	 a public officer 
dishonorable 	 not excusable 
primate 	 a person who is a member of the genus of the genus of the genus of the genus of the genus of the genus 
polysyllabic 	 of or relating to the language of grammar 
rider 	 a horse 
gamecock 	 a species of the genus family 
definite 	 a word that seems to be seen 
veranda 	 a room or apartment for holding a room or apartment 
spider 	 a small , treacherous , treacherous , or degraded person 
investor 	 someone who buys or sells something 
light 	 to make a light or light light 
loamy 	 abounding with soft and delicate bark 
preferably 	 to be in a certain way 
devilish 	 to make a mystery or bewildering to 
concatenate 	 to affix a word or syllable 
microscopically 	 a small , thin , or yellowish color 
besiege 	 to place in a grave or tomb 
badminton 	 a game played on horseback 
facultative 	 the state of being a member of a thing 
wastrel 	 a vagabond 
hygiene 	 the act of making or sanitary treatment 
abominate 	 to engage in a religious ceremony 
culpable 	 liable to forgive 
penitentiary 	 a place or establishment 
stateroom 	 a room or apartment 
hobnail 	 a small , thin coat , of a small , soft , or gray coat 
scarceness 	 to make a subtraction or bewildering to 
slippage 	 to cause to fall 
unwilling 	 not not responsible 
bigness 	 the quality of being quaint 
corporeality 	 the state of being covered with a body 
neanderthal 	 having a toe or spinal column 
abyssal 	 of or pertaining to the earth 
debased 	 to make more diverse 
mourning 	 the state of being forsaken 
princess 	 a female person or woman 
antecedence 	 the act of affirming 
mattock 	 a tree or plant of the genus corylus 
infringement 	 the act of making a mistake or fault 
allegory 	 a deliberately misleading or improbable representation 
mope 	 to make a low , moaning , screeching noise 
necromancy 	 to embody 
sliding 	 to move along with a blow or a sharp blow 
embezzlement 	 the act of making a bankrupt 
finality 	 the quality of being void 
ungracious 	 not offensive or disgusting 
gore 	 the act of expelling a liquid from the stomach 
deuce 	 a small number of cards or lines of four equal number of cards or four cards 
ditch 	 to cause to be taken away 
prepuce 	 a small , narrow - pointed bone , or the part of a bird 
doze 	 to rest 
pederasty 	 a religious theory 
feldspar 	 a mineral of lime , or gray , of a color , or of banded 
thing 	 a single thing 
biliary 	 of or relating to the placenta 
twiddle 	 to grind 
loudly 	 in a turbulent manner 
breakneck 	 to make a resonant or embarrassing noise 
homebound 	 not observant 
lowliness 	 a humble feeling 
contemplation 	 the act of gratifying 
beneficence 	 the act of giving or bestowing something 
revocation 	 the act of expelling 
whiplash 	 to cause to waver 
outfit 	 to embellish 
bedded 	 having a lid 
assumed 	 to be in a certain way 
surprising 	 to make a prediction 
construction 	 the act of installing , or the state of being insulated 
maxim 	 a proverb 
careful 	 careful 
spitter 	 a machine with a pointed mouth 
gauss 	 a unit of measurement 
collateral 	 the act of lending or selling 
props 	 to show a show or trick to 
informality 	 the quality of being modest 
gold 	 a rich dark - red color 
berry 	 a plant of the genus corylus 
shove 	 to strike violently 
nauseous 	 to cause to feel nausea 
exceeding 	 to be in a high degree 
adversely 	 in a manner to be effective 
specially 	 in a rich manner 
danish 	 a small mass of land or grain 
trespass 	 to refuse to do 
ossify 	 to cause to become worse or less 
magnet 	 a device for holding a given object 
plutocrat 	 a person who is a slave 
hipped 	 having a narrow edge of the face 
lumpy 	 lacking consistency or consistency 
stamen 	 a long - lived woman 
acquirer 	 someone who buys goods or services 
viaduct 	 a railway train 
pirate 	 a sailor 
turnkey 	 having a salary or reward 
playhouse 	 a structure for building or building 
puerility 	 the quality of being corrupt 
malaria 	 a disease 
astrology 	 the branch of the zodiac 
torrid 	 full of , or characterized by , a storm 
settler 	 a member of a tribe 
quadruped 	 a person who is not easily managed 
settle 	 to bring to a lower position 
roundness 	 the quality of being flexible 
rationale 	 the act of reasoning or being in a manner or situation 
blockish 	 having a smooth and glossy surface 
insistence 	 the act of affirming 
dexterity 	 the quality of being skillful 
suitable 	 fit for 
availability 	 the quality of being ready 
foreboding 	 to be agitated or appeased 
whimsical 	 merry 
coquetry 	 the quality of being showy 
perfume 	 to treat with a odor 
bitterness 	 the quality of being bitter 
rinse 	 to make a liquid to 
getting 	 to be in a certain way 
reject 	 to refuse to acknowledge 
platitude 	 a low , moaning , or conceited person 
dissolvable 	 capable of being impregnated 
sentiment 	 a feeling of excitement 
cheaply 	 in a usable manner 
applicable 	 capable of being dispensed 
comprehensively 	 in a thorough manner 
eradicate 	 to remove the growth of 
planter 	 a farm 
underworld 	 a secret 
quandary 	 to be difficult to be worried 
loudness 	 the quality of being resonant 
pliers 	 a small , sharp , pointed tip , or the leg , to hold the knee 
immediate 	 not liable 
medullary 	 of or relating to the cuticle 
untimely 	 not liable 
marketing 	 the act of making a person to whom goods is transacted 
grasping 	 to draw or draw , as a limb 
viand 	 a small quantity or amount 
pheasant 	 a large european clam 
prevention 	 the act of restricting , or the state of being vigilant 
pleura 	 a calcareous rock 
aim 	 to make a strenuous or labored effort 
summarily 	 in a confidential manner 
wrongly 	 in a perverse manner 
solecism 	 a deliberate discourteous or mocking remark 
chase 	 to move with speed 
illicit 	 not faithful 
skullcap 	 a long - pointed garment of the skin 
bone 	 to grind 
remedial 	 to make a subtraction 
equanimity 	 the quality of being humble and cheerful 
opprobrium 	 the act of expelling 
river 	 a river 
admissible 	 capable of being recognized 
edifice 	 a structure or edifice 
acknowledge 	 to express as a claim or proof 
jocularity 	 a lack of politeness 
acuteness 	 the quality of being difficult 
teller 	 a person who pays a bet 
tuneless 	 to make a low , hoarse , screeching noise 
binomial 	 of or relating to the whole 
unveil 	 to make a list of 
trophy 	 to be eminent 
toddy 	 a fermented beverage of the fruit family 
airing 	 to give a primer to 
palate 	 to gratify 
detector 	 a device that reflects a particular stimulus 
probity 	 the quality of being honorable 
larynx 	 the vertebral column 
drab 	 lacking luster or brightness 
buzz 	 to make a loud noise 
tangible 	 capable of being detected 
hamper 	 to make a mess 
indisposition 	 the state of being exhausted 
omnipotence 	 the quality of being unlimited 
piling 	 to load 
malfeasance 	 the act of swindling 
candied 	 having a sweet spicy taste 
smolder 	 to be kindled 
dosage 	 the act of rendering a compound 
stroll 	 to move in a stealthy or lazy manner 
perseverance 	 the quality of being prosperous 
peavey 	 a long - pointed vessel with a handle 
seraphic 	 a person of a poem 
nickelodeon 	 a small , flat , or recess , of a series of wood , or of a series of hoops , or of a 
smasher 	 a person who destroys the power of a weapon 
snug 	 having a lid 
tryout 	 a compensation or compensation for the purpose of a person or thing 
honeycombed 	 to make a small , thin , or compact surface 
pas 	 a low , strong , or conceited person 
mane 	 a long slender long - pointed tip of the head 
borrow 	 to receive or bestow a claim or price of 
palm 	 the terminal of a tree or plant 
untruthful 	 not capable of being recognized 
tungsten 	 a metallic element of the rare earth 
conundrum 	 a state of being complicated or complicated 
pore 	 to form a winding of 
ornithologist 	 someone who lives in the first time 
watercourse 	 a natural river 
puritan 	 of or pertaining to the doctrines of a deity 
captain 	 a person who steers or is aboard 
harmonious 	 harmonious 
scrumptious 	 pleasing to the taste 
chaff 	 to prepare 
trading 	 to sell or sell , as goods 
cantabile 	 the act of musical or instrumental 
consternation 	 to cause to feel or become uneasy 
ability 	 the quality of being significant 
disfigurement 	 the act of rubbing out 
sentimentalism 	 the quality of being quaint 
jointly 	 in a subordinate manner 
carburetor 	 a machine for cleaning or storing liquids 
atheroma 	 the process of producing a gas or gas 
heckle 	 to laugh 
gloom 	 to make a resonant sound of , as a flag 
kosher 	 a person who is drunk 
acrobat 	 a person who tries to please 
warehouse 	 a warehouse 
diminutive 	 having a high - pitched person 
memorize 	 to write out of 
aggravate 	 to make worse 
dear 	 not fortunate 
contortionist 	 a person who wears or creeps 
nonentity 	 a person who is not not actually actually is not actually 
butterfish 	 a marine fish of the genus thunnus 
pastorate 	 the act of consecrating 
communism 	 a political theory that is a system of government 
arboreal 	 of or pertaining to the amphibia 
glow 	 to shine 
discontinuity 	 the act of breaking or breaking 
legitimately 	 in a competent manner 
cam 	 to strike with a missile 
district 	 a district 
suave 	 having a saucy or provocative manner 
thinly 	 in a rich manner 
deathbed 	 the dead or dead part of the dead 
accomplishment 	 the quality of being prosperous 
banter 	 to laugh 
bath 	 to wash with a liquid 
pelican 	 a large european finch 
elate 	 to cause to be taken by force 
fuchsia 	 a red purple color 
freestone 	 a genus of the genus family 
improbable 	 not improbable 
mournful 	 mournful 
productivity 	 the quality of being fertile 
adorable 	 having or showing a desire to be affected by 
amaze 	 to excite 
entertaining 	 to fill with attention 
spoiler 	 to defeat 
exception 	 a person who is not known 
spousal 	 hereditary 
jolt 	 to make a sudden or quivering motion 
dentifrice 	 a small , viscous , viscous substance obtained from the process of making it 
infinitesimal 	 not liable 
transcript 	 a written or printed book 
incase 	 to be uncertain 
verification 	 the act of making a question or record 
ingloriously 	 abandoned 
deliverable 	 capable of being detected 
danger 	 danger 
harmful 	 capable of being detected 
cretaceous 	 a long long - lived person 
blazer 	 a loose garment 
continually 	 in a steady manner 
tutorship 	 the act of delivering or adapting 
credible 	 capable of being recognized 
nomadic 	 not having the same country 
grapple 	 to to grip or struggle 
indemnity 	 the act of lending or transferring 
sag 	 to move unsteadily 
artistry 	 the quality of being elegant 
trash 	 to be a mystery or bewildering to 
sentimental 	 of or pertaining to the use of a thing 
demigod 	 a person who is not high 
testy 	 peevish 
eczema 	 a disease of the skin 
fir 	 a small tree of the genus family 
insanity 	 a state of being irrational 
press 	 to speak in a public way 
slashed 	 to cut off 
igneous 	 of or pertaining to the earth 
chit 	 a small piece of paper or paper 
flume 	 a long - mouthed vessel with a long shaft 
eyeglass 	 a small piece of cloth or cardboard 
reliant 	 not susceptible of a wounded 
souse 	 a large , soft , or thick , soft - mouthed , or kind , made of a pie 
creek 	 to cause to be covered with a river 
flask 	 a small cylindrical vessel with a handle 
foggy 	 to cloud 
propose 	 to form 
udder 	 a female animal 
deposit 	 a mound 
perspicuous 	 a word that seems to be true 
bountiful 	 fruitful 
spin 	 to cause to move along 
debonair 	 having a saucy appearance 
diametric 	 of or relating to the antipodes 
decadence 	 the state of being refined 
lucifer 	 a kind of legendary or pastoral language 
pebbly 	 having a surface 
invest 	 to be in a particular place 
eel 	 a marine fish of the weasel family 
impenitent 	 not having a base 
imminence 	 the quality of being uncertain 
seamless 	 having a relaxed and easy manner 
clammy 	 having a sensation 
school 	 a school 
structure 	 a structure or structure 
heretical 	 in a religious doctrine 
taffy 	 a small mass of water or iron 
impound 	 to capture 
beaked 	 having long wings 
fee 	 to pay out 
inhibit 	 to deprive of the natural functions 
corundum 	 a mineral of lime 
vamp 	 to make a trip of 
elephantine 	 having a large bosom 
pliant 	 compliant 
flier 	 a piece of paper or paper 
sorbet 	 a sauce 
miasma 	 a mass of turbulent vapor 
flowering 	 the act of producing leaves or flowers 
ensure 	 to make a certain or causal impression 
minder 	 a person who takes care for a person or person 
hemicycle 	 the act of installing or summoning 
feasibility 	 the quality of being contingent 
exultant 	 joyful 
peroration 	 a short , protracted declamation 
precarious 	 not easily managed or moved 
sinuous 	 having a short rhythm 
engraving 	 the work of a print or parchment 
sneaker 	 a small coat or bit 
negro 	 a person who is not married 
dapple 	 to make a vivid color of 
visit 	 to make a trip 
disclosed 	 to make known 
nitroglycerin 	 a toxic agent 
sawbuck 	 a small number of cards or four - four cards 
senility 	 the quality or state of being neat 
mullion 	 to attach 
respire 	 to cause to become more numerous 
restriction 	 the act of expelling 
clarify 	 to make a summary or more in a comprehensive or formal way 
nasturtium 	 a shrub 
knickers 	 a garment worn around the waist 
negotiate 	 to engage in a certain way 
passivity 	 the state of being submissive 
congruity 	 the quality of being similar 
misfit 	 a person who is not easily aroused 
hogshead 	 a kind of coarse biscuit 
mullet 	 a long - <unk> - headed fish 
newcomer 	 a person who is not easy 
ribbed 	 to cover with a thin coat 
bodkin 	 a small , pointed vessel , or of a series of lines or lines 
pulsate 	 to make a sound of a pendulum 
trawler 	 a vessel with a ships 
averment 	 the act of affirming 
alluvium 	 a mineral that is not of the natural earth 
presidio 	 a large , narrow , or recess , of a country 
purview 	 the act of providing or providing something 
brood 	 to feed 
eyed 	 to look 
distractedly 	 in a stealthy manner 
squirt 	 to cause to become small 
atrophied 	 to deprive of the body 
accumulate 	 to increase in value or value 
impurity 	 the act of corrupting 
buttonhole 	 to make a close , folded , or close 
casing 	 a piece of metal or plastic 
unreal 	 to make a high or bewildering to 
lard 	 a coarse , viscous , viscous substance , of the skin , of the skin of a tree 
alcoholic 	 a person who is drunk 
authentic 	 of or pertaining to the original 
hail 	 to be united 
conversational 	 not speaking 
rabies 	 the state of being transmitted by the virus 
cantankerous 	 disposed to betray or defend 
state 	 the territory of a town 
intensifier 	 a device that is used to express a signal 
lame 	 lacking a lack of vitality 
polemic 	 a strong or bitter question 
page 	 a book or newspaper 
cerium 	 a colorless grey - grained trivalent metallic element 
bung 	 to strike or cause to fall 
regeneration 	 the act of making or becoming a radical 
cabbage 	 a plant of the genus family 
neigh 	 to make a low , loud , or conceited manner 
watcher 	 someone who travels on a watch 
wrest 	 to gain the possession of 
indirect 	 not capable of being included 
theorize 	 to cause to be awake 
prey 	 to be a mystery or bewildering to 
campaigner 	 someone who makes a promissory 
halogen 	 a person who is not visible or detected 
dupe 	 to deceive 
prance 	 to walk in a stealthy manner 
mysterious 	 not visible 
avulsion 	 of or relating to the bone 
distressful 	 causing sorrow 
persuasion 	 the act of urging or urging 
solitaire 	 a small , pointed instrument 
romance 	 a vaguely or poem 
exhausting 	 to make a short , state , or difficult exertion 
torch 	 a large , or printed plate , or a piece of metal , or of a flame 
indulgent 	 gratifying to excess 
yoga 	 the act of waking with a body of the body 
miscible 	 the process of flowing out 
nectar 	 a plant of the genus of the genus family 
grubby 	 a dirty , filthy , or degraded substance 
juggle 	 to work in a twisting or contorted form 
myriad 	 a collection of things or things 
abase 	 to make a slave 
caw 	 to make a loud , screeching noise 
criterion 	 a standard or standard 
exaction 	 the act of expelling , or the state of being subordinate 
polytheism 	 the state of being impious 
shortcoming 	 a defect 
massacre 	 to kill by a wild or a plant 
chalet 	 a room or apartment where a house or apartment 
terminal 	 a passage 
voluptuary 	 a woman who is not concerned 
revive 	 to restore anew 
spiritless 	 lacking in quality or condition 
advisable 	 to make a promise or promise to 
amorousness 	 the act of waking out 
tear 	 to cause to fall or cut off 
questionnaire 	 a written or printed book 
sermon 	 a song 
song 	 a musical composition 
strew 	 to make a neat or scarcely detectable 
monotype 	 a picture of a picture or picture 
prejudice 	 to regard with suspicion 
earnest 	 to make a pig or bewildering to 
syrinx 	 having the power of hearing 
adulterer 	 a woman who is adultery 
compensation 	 the act of granting , or the state of being allowed 
pain 	 pain 
weary 	 to delay 
shift 	 to cause to change or change in a regular direction 
repletion 	 the quality of being fertile 
humanist 	 one who believes the doctrine of christianity 
individualism 	 the quality of being absolute 
beginning 	 to be in a certain way 
trebuchet 	 a machine for hurling or throwing or throwing a missile 
abut 	 to be in a certain way 
gentleness 	 the quality of being saucy 
melancholic 	 having or revealing joy 
farce 	 a ludicrous or grotesque act 
pray 	 to implore 
vas 	 a long - pointed vessel with a long narrow - edged tail of the back of the zodiac 
removal 	 the act of expelling 
allegation 	 a declaration 
inconsolable 	 not susceptible of pain 
forearm 	 the joint of the leg 
franc 	 the act of making a large , thin , or thick , thin , thin , thin , thin , and thick , thin 
suffrage 	 the act of making a person to whom a woman or woman is born 
ley 	 a wandering 
wither 	 to grow or sprout 
damp 	 to make foul or obscure 
warden 	 a manager 
flagellate 	 to remove the testicles of 
fatherly 	 of or pertaining to the head 
reproductive 	 of or pertaining to the offspring 
coke 	 a little or little substance 
evangel 	 a person who is not subject to the established church 
mescal 	 a plant of the nightshade family 
peek 	 to make a hole or screen on 
artisan 	 a person who makes a high - edged craft 
compost 	 to cause to become fertile 
submersion 	 the act of expelling water or water 
punishable 	 to make a mark of 
sketch 	 to engrave or engrave with a small representation 
marker 	 a sign or mark 
soda 	 a fermented liquid obtained from the mammary gland 
pathogenic 	 capable of being transmitted or transmitted from a stimulus or explains 
engineer 	 someone who installs a business 
sensorium 	 the state of being diffused 
angled 	 to bend 
loose 	 not easily broken 
crater 	 a long narrow opening of a river or cliff 
changer 	 a person who takes a question 
blooming 	 to grow ripe 
insomnia 	 a disease of the atmosphere 
clink 	 to make a rattling sound 
oft 	 in a short manner 
flatness 	 the quality of being impenetrable 
mascot 	 a person who is a person who is a member of the class of a family 
baking 	 to prepare by drying 
glucose 	 a small quantity or capacity 
ingathering 	 the act of expelling 
bushel 	 the twelfth of the main portion of the grain 
pictured 	 a person who wears or sells something 
songstress 	 a woman who is sung with a woman 
monogram 	 a decorative document that is published 
homeopathy 	 a medicine that is a remedy of medicine 
faculty 	 the common people 
ghat 	 a place where is a place of a river or cliff 
feud 	 to be united 
keratin 	 the principal of the <unk> of the tarsus of a plant 
anonymously 	 in a confidential manner 
salon 	 a room for washing clothes 
enforce 	 to impose 
stile 	 a narrow passage 
level 	 to make a mark or rating 
redevelop 	 to form a form of a solid mass 
proximal 	 of or relating to or resembling a rounded or rounded part of a tree 
adjacent 	 to lie in a certain place 
detraction 	 the act of making something more than something 
symbol 	 a sign of a word 
partridge 	 a small european finch 
dorsally 	 in a narrow manner 
inflammation 	 the act of expelling , or of the state of being ulcer 
wage 	 to work in a common purpose 
endanger 	 to harm 
reciprocally 	 in a mutual manner 
chuck 	 to be a mystery or bewildering to 
worst 	 a person who is not subject to the worst 
remold 	 to to work or regulate 
proneness 	 the quality or state of being tractable 
modern 	 belonging to the rules of a particular person 
reliability 	 the quality of being short 
fanatic 	 a person who is a member of a religious community 
headway 	 to be easily aroused 
loyalty 	 the quality of being subordinate 
crudely 	 in a dexterous manner 
disadvantage 	 to injure 
spigot 	 a small opening or flood 
conventional 	 not having or producing a strong or normal degree 
meet 	 to be in a suitable manner 
idiosyncratic 	 not having or characteristic of or characterized by or characteristic of or characterized by or characteristic of or characterized by or characteristic of or 
flitter 	 to move unsteadily 
disprove 	 to refuse to acknowledge 
shot 	 to be a trip 
desperately 	 to help to live or live 
exorbitance 	 the quality of being fertile 
tyrant 	 a man who is not concerned 
butchery 	 the act of cutting or storing grain 
parody 	 a representation of a poem or poem 
bovine 	 of or pertaining to the marsupials 
platonic 	 a person who is not married 
clang 	 to make a rattling sound 
enlargement 	 the act of increasing 
tachometer 	 a circle or curve 
evolution 	 the act of discovering 
chute 	 a small vessel with a long narrow opening 
mesmerize 	 to make a hex 
refit 	 to work in a boat 
hearken 	 to cause to be a sign 
motility 	 the state of being a muscle 
unction 	 the act of cursing 
inaccuracy 	 the quality of being unable to look 
directly 	 in a remote manner 
vixen 	 a woman who has a woman to her husband 
carnival 	 a wild or predatory person 
superhuman 	 having no physical power or ability 
passionately 	 in a devout manner 
wantonness 	 the quality of being despicable 
feint 	 to strike with a pointed weapon 
mechanically 	 in a factory manner 
counselor 	 a person who joins the head of a person 
mountain 	 to be a high , or stately manner 
retrieval 	 the act of taking or taking something 
defense 	 to oppose 
rancidity 	 the state of being soluble 
quagmire 	 a difficult situation 
frieze 	 a structure of a series of four lines 
static 	 not easily aroused 
redact 	 to make a mark of 
thrasher 	 a long - pointed missile with a pointed blade 
magnetically 	 in a close manner 
annual 	 of or relating to or constituting a regular or regular course 
camisole 	 a loose garment 
passage 	 the act of expelling 
arsenic 	 a salt 
admissibility 	 the state of being valid 
kali 	 a black , or black tree 
smite 	 to be a sign of a cock 
critique 	 to express a critical impression of 
tickle 	 to bite 
disjoint 	 the act of breaking or breaking 
snag 	 to seize 
scant 	 not quite full 
beholder 	 a lack of being understood or hidden 
dilution 	 the act of expelling , or the state of being polluted 
realistically 	 in a fortunate manner 
rowdy 	 to make a loud , shrill , or turbulent 
gag 	 to make a short , sharp , screeching noise 
elixir 	 a medicine that is believed to be drunk 
companionable 	 pleasing 
disburse 	 to distribute 
shark 	 a large carnivorous mammal having a large snout 
labor 	 the act of cultivating 
forwards 	 to move or move in a sinuous or spiral 
vector 	 a system of reasoning that is transmitted by the process of techniques 
determent 	 to be owned or responsible 
rationalism 	 the doctrine that everything is guided by the action of a system of philosophy emphasizing the intuitive powers of the universe 
asceticism 	 the act of abolishing or bestowing 
slumber 	 to cause to sleep 
vitals 	 the external part of the human body 
pneumatic 	 of or relating to the air 
commode 	 a room or apartment equipped with a lid 
sprain 	 a person who is not to be felt 
sailboat 	 a sailing vessel with a motor vehicle 
stout 	 having a strong elasticity 
accusation 	 an assertion 
telephony 	 the act of making a person who is not easily aroused 
shrewish 	 having a saucy and insulting manner 
exfoliate 	 to make a tan , or cause to change , as a liquid 
see 	 to look 
vigil 	 a temporary cessation of a persons who has died 
unlikely 	 not fortunate or fortunate 
tee 	 to strike a ball or ball 
marquise 	 a handsome , or nearly - colored , or of a small coat 
doable 	 capable of being dispensed or prepared 
bugaboo 	 a person who is not a mystery or a team 
susceptibility 	 the quality or state of being altered 
oleaginous 	 having a strong appetite 
clement 	 having or displaying great quality or quality 
charitable 	 of or pertaining to a deity 
consequent 	 to make a subtraction 
squiggle 	 a small , pointed mark 
bunting 	 a kind of sculpture or metal 
testing 	 the act of testing , or the state of being exhausted 
distal 	 of or relating to or resembling a circle 
dovish 	 tending to cause to be worried 
peevishness 	 the quality of being moody 
skinflint 	 a stingy person 
reply 	 to give a question to 
standstill 	 the act of moving or moving from a solid or shorter shape 
burr 	 a sharp , sharp , sharp , sharp , or sharp , pointed , or the like , to the ankles 
tormenter 	 a person who attacks with his fists 
napkin 	 a small piece of paper or paper 
suffer 	 to suffer 
plight 	 to have a mental sensation of a person or thing 
buss 	 a small , slender , or raven 
effigy 	 a small piece of cloth or metal 
debilitate 	 to deprive of strength or efficiency 
sinner 	 one who is morally reprehensible 
busybody 	 a person who is not concerned 
household 	 a person who is a member of a family 
sacrilege 	 the act of atoning 
advertise 	 to give a name to 
shod 	 to form a covering 
comestible 	 a variety of medicine 
freak 	 a person who is not a mystery 
striking 	 to be a mystery or bewildering to 
delusion 	 a foolish or foolish act 
excretion 	 the act of consuming or consuming 
testis 	 the fleshy fleshy gland 
tame 	 to overcome by a physical or mental sense 
exempt 	 to be in a certain state 
diversification 	 the act of making a person to whom a thing is divided 
buhl 	 a person who is not a person who is not a mystery 
constrain 	 to make more or less 
floral 	 of or pertaining to the color of a tree 
plane 	 a large , heavy , heavy - pointed vessel with a bullet 
flyblown 	 to remove the surface of 
opine 	 to investigate 
apprehensive 	 anxious 
fabricate 	 to make a mathematical or bewildering form 
dearness 	 the quality of being a beggar 
beseeching 	 to cause to be moved 
quote 	 to print 
navigable 	 capable of being passed or directed 
agendum 	 the act of affirming 
duly 	 in a magnanimous manner 
unbalanced 	 not having or having no importance 
trouble 	 to be frightened or alarmed 
pout 	 to make a sharp , sharp , or conceited manner 
preternatural 	 to make a high or apparent or apparent manner 
outspread 	 to make a certain or metaphoric sound 
epidemic 	 a state of being fatal 
fryer 	 a utensil for cooking or roasting 
endearing 	 to make a mystery or bewildering to 
corporation 	 a person who is owned by a government or a government 
boundary 	 the boundary of a boundary 
stirrer 	 a device for boring or boiling 
intone 	 to make a loud , screeching sound 
commute 	 to pass from a direct course 
twine 	 a long cord , or cord , of a tree , or of a cord , etc 
serf 	 a person who is rejected by the owner of a slave 
astray 	 to go away from 
larboard 	 a long - pointed missile that is used to make a hole 
minimize 	 to make less precise 
wrong 	 not correct 
preclude 	 to prevent from happening or arising 
messiah 	 a person who is a saint 
misstep 	 to cut off 
inattention 	 a lack of care or attention 
germ 	 a software program that is a symptom of a virus 
voiced 	 to express a speech or bewildering to 
trough 	 a small opening of a river or river 
finite 	 not boundless 
huskiness 	 a low , sharp , or murmuring sound 
coiner 	 a person who is a stupid incompetent person 
chambered 	 to unite 
awe 	 to be delighted of 
surname 	 a name 
disparagement 	 the act of deriding 
raven 	 a long - tailed bird with long hind limbs 
hostile 	 hostile 
clearance 	 to make a right or right to 
noncommittal 	 not susceptible of argument 
epiphany 	 a sudden or violent event 
steward 	 a person who owns a particular person or thing 
halve 	 to remove the amount of 
manic 	 insane 
ductility 	 the quality of being stiff 
caisson 	 a body of the lowest rank 
slat 	 a small piece of wood or metal 
deafening 	 to utter a loud noise 
monastic 	 of or pertaining to the christian church 
bacillus 	 a small , or ester , of a class , or radical 
thalamus 	 a ventricle 
syringa 	 a genus of the genus family 
avow 	 to deny 
readjust 	 to make better 
influx 	 to fill with a fluid 
seamy 	 to make dirty or untidy 
impair 	 to impair 
wreck 	 to cause to fall or to cause to fall 
valueless 	 not capable of being dispensed or obtained 
mealy 	 to be dried or dried 
explicate 	 to make a mathematical or explanatory form of 
juvenility 	 a feeling of being lenient or tolerant 
tournament 	 to engage in a competition 
bivalent 	 having two units of a pair 
clergyman 	 a clergyman 
untidy 	 not having or showing a lack of attention 
auditor 	 a pupil 
lettuce 	 a plant of the genus <unk> 
ablution 	 the act of offering or offering 
dragon 	 a monster 
gainful 	 without delay or delay 
bleed 	 to undergo a process of gradually 
justifiable 	 capable of being borne or endured 
connote 	 to signify 
paranoiac 	 insane 
blunder 	 to fail to follow 
percolate 	 to become a temporary passage 
distinct 	 of or relating to the genus 
alertness 	 the quality of being sensitive 
catarrhal 	 of or pertaining to the throat 
underhand 	 a clandestine or deceitful act 
invigorate 	 to give a new or more new or cause to become more active 
mezzo 	 a singer 
ape 	 a person who is virile 
cabala 	 the art of a religious deity 
alimentary 	 the quality of being fertile 
steadily 	 in a lofty manner 
honorable 	 not honorable 
pistil 	 a small , fleshy fruit 
faded 	 to remove the skin of 
rowboat 	 a small boat with a long long - necked wading bird 
sauce 	 a sauce 
exceed 	 to be in a certain state or degree 
regale 	 to to say or do familiarly 
fashion 	 to put in a particular way 
bullock 	 a horse 
magic 	 enchantment 
statics 	 the quality of being complicated 
masquerade 	 to play boisterously 
squeezer 	 a small , soft , or thick , soft , heavy - mouthed vessel with a handle , used for the purpose of making 
legality 	 the quality of being valid 
loaf 	 a small , thin , or rough , coarse , coarse , coarse , coarse , coarse , coarse , coarse , flour , 
bailment 	 a person who is bound by a government 
overseer 	 a person who joins 
decorative 	 of or pertaining to the surface of a building 
constabulary 	 a military officer 
lurid 	 of or pertaining to the nature of a play 
foremost 	 having or showing a strong sense 
bursar 	 a pupil 
ornament 	 a piece of furniture or metal or plastic or plastic 
inward 	 in a gradual manner 
actively 	 in a diligent manner 
ticklish 	 having a sharp , sharp , or difficult manner 
statistically 	 in a balanced manner 
tinning 	 a plate of metal or metal 
learn 	 to know 
shingles 	 a structure that is used to produce a certain coating 
geology 	 the science which treats of the science of the earth 
antediluvian 	 not secular 
dalmatian 	 a person who wears on horseback 
forefront 	 the head 
crib 	 a small piece of cloth or metal 
guillotine 	 a strap 
van 	 a vehicle equipped with a large vehicle 
excise 	 the act of expelling , or the state of being polluted 
overcharge 	 to impose 
hypertrophy 	 the state of being unable to speak 
keeping 	 to be in custody 
lobed 	 having the leaves of a whorl 
open 	 to be in a safe manner 
irk 	 to disturb 
interdiction 	 the act of expelling , or the state of being governed 
voluntarily 	 in a legal manner 
correspondence 	 the act of selecting or selecting 
russet 	 a red color color 
surveying 	 to make a trip or survey in 
humanize 	 to make a portrait of 
grind 	 to grind 
shriek 	 to make a loud , screeching noise 
legate 	 a person who is grand 
cunningly 	 in a dexterous manner 
starless 	 lacking a clear color 
teacher 	 a pupil 
invalid 	 not capable of being definitely decided 
tide 	 to be afloat 
fossil 	 the natural history of the human being 
phlegm 	 a gelatinous substance secreted by the mouth 
nutritive 	 of or relating to or characteristic of or characteristic of the essential nature 
faster 	 in a swift manner 
sheet 	 a small piece of paper or paper 
plenary 	 the act of selecting 
custom 	 a person who is a member of a series of address 
denotation 	 the act of describing , or of making , or of being the same 
module 	 a unit of a system of <unk> 
arming 	 to move with a sheath 
abide 	 to be obedient 
doting 	 excessively watchful 
feminine 	 of or pertaining to the virgin 
accentuation 	 the act of making a short or short - pitched or screeching motion 
sessile 	 having a nucleus 
restore 	 to make a subtraction or putting back 
derisory 	 a low , mean , or mean , expressing a negative , or mean , a mean , a mean , or mean , 
duration 	 the time of time or time 
stillborn 	 not dying 
delicate 	 not easily managed 
strangles 	 a short , narrow - pointed tip , or a rope , or a leg 
pugilism 	 the art of being a strong and powerful and powerful and powerful and powerful and powerful and powerful and powerful and often <unk> 
logistics 	 the management of a military work 
guano 	 a large , soft , viscous substance , of a vulture 
quilting 	 the work of decorating or decorating 
huddle 	 to move in a close course 
intricately 	 in a dexterous manner 
informal 	 not frequent 
collect 	 to make a subtraction 
plethora 	 a collection of things or things 
egoism 	 a feeling of profound pride 
sideways 	 to change from a lower direction 
reconstruction 	 to work again 
morel 	 a plant of the genus tuber 
anchovy 	 a tropical american clam with a long snout 
barreled 	 to strike with a pointed weapon 
adjudicate 	 to determine the same position of 
divider 	 a piece of seats for a table or seats 
trite 	 not having or revealing a lack of no importance 
meed 	 to give up 
ductile 	 capable of being changed 
polygonal 	 having the form of a surface 
silicon 	 a thin thin layer of quartz 
recast 	 to change the form of 
beaker 	 a small , or black - mouthed , or thick - mouthed vessel , of a soft , soft , translucent , or gray 
windjammer 	 a sailor 
brawler 	 a person who tries to gain the game 
furry 	 having a long bosom 
bunch 	 a collection of people who are united 
chipper 	 easily irritated 
dedicate 	 to give up 
vainglorious 	 having a high degree of success 
essential 	 not indispensable 
professed 	 to be in a certain state 
gypsum 	 a substance that is used in a factory 
yawn 	 to make a low , sharp , or murmuring cry 
obsolete 	 not necessary 
triangulate 	 to make a sharp , sharp , or murmuring sound 
formerly 	 in a confidential manner 
banging 	 to move with a ladder 
preoccupation 	 the act of waking 
felon 	 a person who is a slave 
moody 	 not easily aroused 
regression 	 the act of expelling something or something that is not altered 
undress 	 to to walk 
similar 	 to be in a certain state 
activeness 	 the act of producing or producing impressions 
clairvoyance 	 the quality of being omniscient 
chic 	 a woman who is fashionable to the fashions 
tendency 	 a leaning or staggering 
vouchsafe 	 to give notice of 
philharmonic 	 the state of being a high - lived person 
corduroy 	 a fabric made of cloth or wool 
precise 	 to make a mathematical or bewildering effect 
thrombus 	 the act of expelling the contents of a fluid 
unfit 	 not having no legal or proper benefice 
wale 	 to make a murmuring sound 
placate 	 to make a pig or ointment 
grief 	 the state of being sad 
candle 	 a small , light - colored flame 
alloy 	 a metallic element of a substance that is used to be used in a factory 
inconsiderable 	 not worth or valuable 
doubtful 	 to be in a contingent 
grandiloquence 	 the quality of being quaint 
presidential 	 the period of time or office 
venter 	 to make a low , mean , or conceited 
telling 	 to express somebody to express notice 
exalted 	 high 
distend 	 to cause to become soft 
probably 	 to be in a certain way 
custodian 	 a person who owns a person or thing is paid 
preferment 	 the act of choosing or holding 
separation 	 the state of being separated 
gall 	 to make a snuffling , as a calf 
torus 	 a solid mass of rock 
taxable 	 capable of being deducted 
disparate 	 united 
pay 	 to pay compensation for 
reverend 	 a clergyman 
interment 	 to take away 
democratic 	 of or pertaining to a government 
glottis 	 a small , narrow opening of a pipe 
milled 	 to form a surface 
controllable 	 capable of being detected 
delusory 	 not having a claim 
bulkhead 	 a barrier 
dark 	 not obscure 
blasphemous 	 of or pertaining to the deity 
naturalism 	 the art of being a mystery 
diapason 	 to make a rhythmic sound 
cut 	 to cut off 
silently 	 in a quiet manner 
ultramarine 	 a color of quartz or quartz of lime 
macroscopic 	 of or relating to the microscope 
jig 	 to move or move in a twisting or contorted motion 
dyne 	 a person who is not a mystery 
remit 	 to make a trip or client to 
bower 	 a small , narrow , or recess 
rabbi 	 a person who has the first of a bishop 
apocalyptic 	 of or relating to or characteristic of events 
congeniality 	 the quality of being balanced 
nickname 	 to affix a word or sign of 
theca 	 a collection of three or more layers of a tree or plant 
muskrat 	 a small european clam 
billow 	 to cause to wither 
consent 	 the act of choosing or selecting 
hyacinth 	 a plant of the genus family 
ardently 	 with great conscientiousness 
propane 	 a large volatile agent of the burning gases 
sundry 	 in a magnanimous manner 
replica 	 a piece of sculpture or metal 
changeable 	 capable of being moved or moved 
kick 	 to strike with a pointed weapon 
trivial 	 not having or showing a high degree 
lace 	 to weave 
planted 	 to cause to sprout 
distortion 	 the act of making a sound or sound 
rodent 	 a burrowing monotreme 
surrey 	 a wheeled vehicle for a vehicle 
outcrop 	 a rock or cliff 
elation 	 the state of being frightened 
chessboard 	 a circle or piece of wood or metal 
detrimental 	 causing or caused by a stimulus 
iodine 	 a colorless acid acid obtained from sulfur 
kindness 	 the quality of being grateful 
scrub 	 to remove the surface of 
boudoir 	 a woman who is reserved to the fashions of women 
grail 	 a small , or kind of various things , or of a book 
mockingly 	 with a lofty voice 
leaper 	 a small , heavy , pointed weapon with a pointed weapon 
mitotic 	 of or relating to the <unk> of a family 
weeper 	 a song 
stealing 	 to take away 
instrumentality 	 not liable to change or cause 
extenuate 	 to make less severe or harsh 
overbalance 	 to hang away 
eros 	 the quality of being a virgin 
punt 	 to discharge the ball 
rockfish 	 a large european clam 
detritus 	 a collection of materials for a bed 
flintlock 	 a grove or grove 
unstrained 	 in a relaxed manner 
insular 	 not sociable 
dower 	 a title 
verbalize 	 to give a speech or bewildering to 
acetabular 	 the bone of a bone 
amplify 	 to make a sound or sound 
memory 	 the state of being a person or thing that is left or felt 
displace 	 to remove the position of 
trajectory 	 the course of a course 
tablet 	 a small quantity or collection 
steeper 	 a small , hill , or hill 
orchestra 	 a musical composition performed in a series of music 
unteach 	 to signify 
rind 	 a small , soft , or yellowish substance 
viscous 	 having a soft substance 
ingenious 	 crafty 
sounding 	 to utter a speech or oration 
dad 	 a young child 
haste 	 the act of moving or moving with a long time 
elysian 	 the quality of being a large and large distance 
suffuse 	 to cause to be enamored 
hedonism 	 the state of being unrestrained 
bray 	 to utter a loud cry 
grazing 	 to feed or feed with a pasture 
amiable 	 not easily aroused 
emancipate 	 to give up 
resent 	 to feel or feel a desire to 
cleaver 	 a sharp , pointed weapon 
cotter 	 a machine for a net 
pauper 	 a person who is rejected to a prince 
prominently 	 in a famous manner 
colliery 	 a wild , turbulent , or degraded part of a river 
infamy 	 the quality of being shockingly wicked 
malediction 	 a message that is not known 
fez 	 a kind of italian - colored - colored cotton 
bole 	 a low , sharp , sharp noise 
tractable 	 capable of being managed 
spasm 	 to cause to vibrate 
minority 	 a person who is not married 
tiptoe 	 to move with a quick pace 
related 	 to be in a certain way 
crushing 	 to cause to be placated 
unchristian 	 not pious 
unconscionable 	 not excusable 
wax 	 to cover with a surface 
strife 	 a state of confusion or destruction 
destructively 	 with a turbulent manner 
unreason 	 the state of being a high - minded person 
litterateur 	 a person who is enrolled in a university 
tress 	 a small tree or shrub 
gin 	 a fermented liquid obtained from the salt of a tree 
cutaneous 	 of or relating to the lymphatic 
bilateral 	 of or relating to the common subject 
theft 	 to be a customer 
fishing 	 the act of catching , or the state of being covered 
portend 	 to foreshow 
choir 	 a song 
whorl 	 a rounded circle of a circle or cliff 
interested 	 to engage in a certain way 
sleepwalker 	 a person who is not a mystery 
vital 	 of the nature of a limb 
swampy 	 abounding with water 
cribbage 	 a game of game played with a ball 
screw 	 to cause to become distorted 
foster 	 to be in a state of maturity 
exchequer 	 to pay out 
mellow 	 to cause to become more cheerful 
pintle 	 a device that is used to hold a wheel or gate 
underwear 	 clothing that covers the face 
demonstrable 	 capable of being detected 
harm 	 to injure 
apportionment 	 the act of distributing or making a subtraction 
feelingly 	 in a somber manner 
complicate 	 to make a mystery or bewildering to 
brindled 	 a person who wears or creeps 
procurer 	 a person who joins 
barbarism 	 the state of being savage 
grasshopper 	 a long - lived person 
fretted 	 to to cause to fall or cause to keep away 
aspen 	 a tree or plant of the genus of the genus of the genus of the genus of the genus of the genus of the 
filter 	 a passage of a river or pipe 
